
F 220,100,100
C 21,30,56

NO ./xpm/file1.xpm
SO ./xpm/file2.xpm
WE ./xpm/file3.xpm
EA ./xpm/file4.xpm

1111111111111111111111111111111
000000000110000000000001
10110000011100000000000011111111
10010000000000000000000000000001
1111111110110000011100000000000011111111
1000000000110000011101111111111111111111
11110111111111011100000010001
11110111111111011101010010001
10000000000000001100000010001
10000000000000001101010010001
110000011101010111110111100111
11110111 1110101 101111010001
111111111 1111111 111111111111111