
F 220,100,100
C 21,30,56

NO ./xpm/file1.xpm
SO ./xpm/file2.xpm
WE ./xpm/file3.xpm
EA ./xpm/file4.xpm

1111111111111111111111111
1000000000110000000000001
1011000001110000110000001
1001011111000000010000001
1001010010000N00010000001
1001010001000000010000001
1001011111000000010000001
1111111111111111111111111