
F 220,100,100
C 21,30,56

NO ./xpm/file1.xpm
SO ./xpm/file2.xpm
WE ./xpm/file3.xpm
EA ./xpm/file4.xpm

        1111111111111111111111111
        1000000000110000000000001
        1011000001110000000000001
        1001000000000000000000001
111111111011000001110000000000001
100000000011000001110111111111111
111101111111101110000001000011
111101110111111011101010010001
110000001101010111000000100001
1000000000000000001100000010001
10000N000000000011010100100001
110000011101010111110111100111
11110111 1110101 1011110100001
1111111 1111111 11111111111111111111